1111111
1PCECP1
110C011
1111111
